100900000009
900000000069
000099900000
000099000000
000000000060
999002000000